NO ./sprites/north.xpm
SO ./sprites/south.xpm
WE ./sprites/west.xpm
EA ./sprites/east.xpm

F 30,30,30
C 150,150,150

1111111111111111111
1000100000000000101
10N0101011111100101
1000101010000000101
1010001010111111101
1011111010000000001
1000001011101111111
1111101010000001111
1000001010100000111
1011111011111111111
1000001000000000001
1111101000000000001
1000001000000000001
1111111111111111111
