NO ./../sprites/north.xpm
SO ./../sprites/south.xpm
WE ./../sprites/west.xpm
EA ./../sprites/east.xpm

F 255,0,0
C 75,0,130

1111111 11111
1000001 10001
1111001110001
   1000000001
11110000000N1
1111111111111
