NO ./sprites/north.xpm
SO ./sprites/south.xpm
WE ./sprites/west.xpm
EA ./sprites/east.xpm

F 30,30,30
C 150,150,150

1111111 11111
1000001 10001
1111001110001
   1000100001
1111000W00001
11111 111111
