NO ./path_to_the_north_texture.xpm
SO ./path_to_the_south_texture.xpm
WE ./path_to_the_west_texture.xpm
EA ./path_to_the_east_texture.xpm
F 220,100,0
C 225,3,0

1111111 11111
1000001 10001
1111001110001
   1000000001
11110000000N1
1111111111111
