NO ./sprites/north.xpm
SO ./sprites/south.xpm
WE ./sprites/west.xpm
EA ./sprites/east.xpm

F 30,30,30
C 150,150,150

1111111111111
1000001110001
1111001110001
1111000000001
11110000000W1
1111111111111
